########################################
#E..................$....#.............#
#....#....#####..........#.............#
#....#....#...#..........#...M.....#...#
#....#....#...#....#.....#####.....#...#
#....#....#...#....#...............#...#
#.........#####....#.....#####.....#...#
#...$..............#.....#...#.....#...#
#..................#.....#...#.....#...#
#..####............#.....#...#.....#...#
#..#..#..................#...#.....$...#
#..#..#....$.............#####.........#
#..M..#................................#
########################################