########################################
#E.......................#...$.........#
#....#....#####..........#.............#
#....#....#...#..........#...M.....#...#
#....#....#...#....#.....#####.....#...#
#....#....#...#....#............$..#...#
#.........#####....#.....#####.....#...#
#..................#.....#...#.....#...#
#.$................#.....#...#.....#...#
#.....#............#.....#...#.....#...#
#.....#..................#...#.....$...#
#.....#....$.............#####.........#
#..M..#.........................M......#
########################################